The	N
pair	N
sought	C
a	N
Metropolitan	C
Police	N
report	N
they	N
hoped	N
could	N
assist	C
their	N
defence	C
.	N
	
Pavlensky	N
and	N
Oksana	N
were	N
detained	C
in	N
December	N
at	N
Sheremetyevo	C
airport	N
for	N
questioning	C
,	N
which	N
went	N
on	N
for	N
seven	N
hours	N
.	N